10 10
0100102010
0001010010
0101000100
0101100110
0100101010
1100101011
0001001011
01r0000000
0111110111
1111111111
